033300000000000003330
311333000000000333113
311132300000003231113
311113230000032311113
311133223333322331113
311133322232223331113
311323222222222323113
033223222202222322330
032222222000222222230
003233320000023332300
032300030000030003230
033003303000303300330
333003303000303300333
032300030000030003230
332033300000003330233
003011000030000110300
033300000000000003330
000033000000000330000
000003320000023303330
000000320000023003223
0000032203030223003223
0000032200300223000323
0000322220000222303223
000032222020022233223
00003223203023003033
000032232030230033
0000032232323223
0000003333333333


