level 1
11111111111111111
22222222022222222
33333330003333333
11111100000111111
22222000000022222
33330000000003333
11100000000000111
22000000000000022
30000000000000003
22222222222222222
11111111111111111